
#music: 1- 10
#background 1-10

#Tile:UPPERCASE
#Block,item block:lowercase
#Enemy: number

###START MAP#####
#EACH CHARACTER IS AN BLOCK, TOTAL HEIGHT 30 WITH A BLOCK IS 32 pixel
>
//////////////////////////////////////////////////////////////////////////////////////////////////////////////////////////////////
/                                                                                                                                /
/                                                                                                                                /
/                                                                                                                                /
/                                                                                                                                /
/                                                                                                                                /
/                                                                                                                                /
/                                                                                                                                /
/                                                                                                                                /
/                                                                                                                                /
/                                                                                                                                /
/                                                                                                                                /
/                                                                                                                                /
/                                                                                                                                /
/                                                                                                                                /
/                                                                                                                                /
/                                                                                                                                /
/                                                                                                                                /
/                                    EBBBBBF                                                                                     /
/                                   EGAAAAAHF                                                                                   /
/                                  EGAAAAAAAHF                                                                                   /
/                              MN EGAAAAAAAAAHF                                                                                  /
/                              OP CAAAAAAAAAAAHF                         UVVVW                                                   /
/                             QOP CAAAAAAAAAAAAHF                         XYZ                                                    /
/                             ROP CAAAAAAAAAAAAAHF                 UVVVW  XYZ                                                    /
/                             ROP CAAAAAAAAAAAAAAHF                 XYZ   XYZ                                                    /
/BBBBBBBBBBBBBBBBBBBBBBBBBBBBBBBBBGAAAAAAAAAAAAAAAHBBBBBBBBBBBBBBBB XYZ   XYZ    BBBBBBBBBBBBBBBBBBBBBBBBBBBBBBBBBBBBBBBBBBBBBBBB/
/AAAAAAAAAAAAAAAAAAAAAAAAAAAAAAAAAAAAAAAAAAAAAAAAAAAAAAAAAAAAAAAAAA XYZ   XYZ    AAAAAAAAAAAAAAAAAAAAAAAAAAAAAAAAAAAAAAAAAAAAAAAA/
/AAAAAAAAAAAAAAAAAAAAAAAAAAAAAAAAAAAAAAAAAAAAAAAAAAAAAAAAAAAAAAAAAA XYZ   XYZ    AAAAAAAAAAAAAAAAAAAAAAAAAAAAAAAAAAAAAAAAAAAAAAAA/
/AAAAAAAAAAAAAAAAAAAAAAAAAAAAAAAAAAAAAAAAAAAAAAAAAAAAAAAAAAAAAAAAAA XYZ   XYZ    AAAAAAAAAAAAAAAAAAAAAAAAAAAAAAAAAAAAAAAAAAAAAAAA/
<